"hero_chat_wheel"
{
"dota_chatwheel_label_antimage_laugh"	"[Risata]"
"[english]dota_chatwheel_label_antimage_laugh"	"[Laugh]"
"dota_chatwheel_label_axe_laugh"	"[Risata]"
"[english]dota_chatwheel_label_axe_laugh"	"[Laugh]"
"dota_chatwheel_label_bane_laugh"	"[Risata]"
"[english]dota_chatwheel_label_bane_laugh"	"[Laugh]"
"dota_chatwheel_label_bloodseeker_laugh"	"[Risata]"
"[english]dota_chatwheel_label_bloodseeker_laugh"	"[Laugh]"
"dota_chatwheel_label_crystal_maiden_laugh"	"[Risata]"
"[english]dota_chatwheel_label_crystal_maiden_laugh"	"[Laugh]"
"dota_chatwheel_message_crystal_maiden_1"	"Sarai un bellissimo angelo di neve."
"[english]dota_chatwheel_message_crystal_maiden_1"	"You'll make a nice snow angel."
"dota_chatwheel_label_crystal_maiden_1"	"Sarai un bellissimo angelo di neve."
"[english]dota_chatwheel_label_crystal_maiden_1"	"You'll make a nice snow angel."
"dota_chatwheel_label_drow_ranger_laugh"	"[Risata]"
"[english]dota_chatwheel_label_drow_ranger_laugh"	"[Laugh]"
"dota_chatwheel_label_earthshaker_laugh"	"[Risata]"
"[english]dota_chatwheel_label_earthshaker_laugh"	"[Laugh]"
"dota_chatwheel_message_earthshaker_4"	"Stava diventando troppo affollato."
"[english]dota_chatwheel_message_earthshaker_4"	"It was getting far too crowded."
"dota_chatwheel_label_earthshaker_4"	"Stava diventando troppo affollato."
"[english]dota_chatwheel_label_earthshaker_4"	"It was getting far too crowded."
"dota_chatwheel_label_juggernaut_laugh"	"[Risata]"
"[english]dota_chatwheel_label_juggernaut_laugh"	"[Laugh]"
"dota_chatwheel_label_mirana_laugh"	"[Risata]"
"[english]dota_chatwheel_label_mirana_laugh"	"[Laugh]"
"dota_chatwheel_label_morphling_laugh"	"[Risata]"
"[english]dota_chatwheel_label_morphling_laugh"	"[Laugh]"
"dota_chatwheel_label_nevermore_laugh"	"[Risata]"
"[english]dota_chatwheel_label_nevermore_laugh"	"[Laugh]"
"dota_chatwheel_label_phantom_lancer_laugh"	"[Risata]"
"[english]dota_chatwheel_label_phantom_lancer_laugh"	"[Laugh]"
"dota_chatwheel_label_puck_laugh"	"[Risata]"
"[english]dota_chatwheel_label_puck_laugh"	"[Laugh]"
"dota_chatwheel_message_puck_3"	"La più grande tragedia del nostro eone."
"[english]dota_chatwheel_message_puck_3"	"The greatest tragedy of our eon."
"dota_chatwheel_label_puck_3"	"La più grande tragedia del nostro eone."
"[english]dota_chatwheel_label_puck_3"	"The greatest tragedy of our eon."
"dota_chatwheel_label_pudge_laugh"	"[Risata]"
"[english]dota_chatwheel_label_pudge_laugh"	"[Laugh]"
"dota_chatwheel_label_razor_laugh"	"[Risata]"
"[english]dota_chatwheel_label_razor_laugh"	"[Laugh]"
"dota_chatwheel_message_razor_2"	"Le tue ceneri cadranno come pioggia."
"[english]dota_chatwheel_message_razor_2"	"Your ashes will fall like rain."
"dota_chatwheel_label_razor_2"	"Le tue ceneri cadranno come pioggia."
"[english]dota_chatwheel_label_razor_2"	"Your ashes will fall like rain."
"dota_chatwheel_label_sand_king_laugh"	"[Risata]"
"[english]dota_chatwheel_label_sand_king_laugh"	"[Laugh]"
"dota_chatwheel_message_sand_king_3"	"Dove credi di andare?"
"[english]dota_chatwheel_message_sand_king_3"	"Where do you think you're going?"
"dota_chatwheel_label_sand_king_3"	"Dove credi di andare?"
"[english]dota_chatwheel_label_sand_king_3"	"Where do you think you're going?"
"dota_chatwheel_label_storm_spirit_laugh"	"[Risata]"
"[english]dota_chatwheel_label_storm_spirit_laugh"	"[Laugh]"
"dota_chatwheel_label_sven_laugh"	"[Risata]"
"[english]dota_chatwheel_label_sven_laugh"	"[Laugh]"
"dota_chatwheel_label_vengefulspirit_laugh"	"[Risata]"
"[english]dota_chatwheel_label_vengefulspirit_laugh"	"[Laugh]"
"dota_chatwheel_label_windrunner_laugh"	"[Risata]"
"[english]dota_chatwheel_label_windrunner_laugh"	"[Laugh]"
"dota_chatwheel_label_zuus_laugh"	"[Risata]"
"[english]dota_chatwheel_label_zuus_laugh"	"[Laugh]"
"dota_chatwheel_message_zuus_2"	"Ci vuole solo questo per ucciderti?"
"[english]dota_chatwheel_message_zuus_2"	"That's all it takes to kill you?"
"dota_chatwheel_label_kunkka_laugh"	"[Risata]"
"[english]dota_chatwheel_label_kunkka_laugh"	"[Laugh]"
"dota_chatwheel_label_lina_laugh"	"[Risata]"
"[english]dota_chatwheel_label_lina_laugh"	"[Laugh]"
"dota_chatwheel_message_lion_laugh"	"Who-ha-ha-ha-ha-ha-ha-he-hawha!"
"[english]dota_chatwheel_message_lion_laugh"	"Who-ha-ha-ha-ha-ha-ha-he-hawha!"
"dota_chatwheel_label_lion_laugh"	"[Risata]"
"[english]dota_chatwheel_label_lion_laugh"	"[Laugh]"
"dota_chatwheel_label_shadow_shaman_laugh"	"[Risata]"
"[english]dota_chatwheel_label_shadow_shaman_laugh"	"[Laugh]"
"dota_chatwheel_message_slardar_laugh"	"Heh heeh heh hah hah ha hah hah!"
"[english]dota_chatwheel_message_slardar_laugh"	"Heh heeh heh hah hah ha hah hah!"
"dota_chatwheel_label_slardar_laugh"	"[Risata]"
"[english]dota_chatwheel_label_slardar_laugh"	"[Laugh]"
"dota_chatwheel_label_tidehunter_laugh"	"[Risata]"
"[english]dota_chatwheel_label_tidehunter_laugh"	"[Laugh]"
"dota_chatwheel_label_witch_doctor_laugh"	"[Risata]"
"[english]dota_chatwheel_label_witch_doctor_laugh"	"[Laugh]"
"dota_chatwheel_label_lich_laugh"	"[Risata]"
"[english]dota_chatwheel_label_lich_laugh"	"[Laugh]"
"dota_chatwheel_label_riki_laugh"	"[Risata]"
"[english]dota_chatwheel_label_riki_laugh"	"[Laugh]"
"dota_chatwheel_message_riki_4"	"Sono stato qui per tutto il tempo."
"[english]dota_chatwheel_message_riki_4"	"I've been here the whole time."
"dota_chatwheel_label_riki_4"	"Sono stato qui per tutto il tempo."
"[english]dota_chatwheel_label_riki_4"	"I've been here the whole time."
"dota_chatwheel_message_riki_5"	"Oh, sei morto. Che sorpresa."
"[english]dota_chatwheel_message_riki_5"	"Oh you're dead. What a surprise."
"dota_chatwheel_label_riki_5"	"Oh, sei morto. Che sorpresa."
"[english]dota_chatwheel_label_riki_5"	"Oh you're dead. What a surprise."
"dota_chatwheel_label_enigma_laugh"	"[Risata]"
"[english]dota_chatwheel_label_enigma_laugh"	"[Laugh]"
"dota_chatwheel_message_tinker_laugh"	"Ah ha ha ha ha!"
"[english]dota_chatwheel_message_tinker_laugh"	"Ah ha ha ha ha!"
"dota_chatwheel_label_tinker_laugh"	"[Risata]"
"[english]dota_chatwheel_label_tinker_laugh"	"[Laugh]"
"dota_chatwheel_label_sniper_laugh"	"[Risata]"
"[english]dota_chatwheel_label_sniper_laugh"	"[Laugh]"
"dota_chatwheel_label_necrolyte_laugh"	"[Risata]"
"[english]dota_chatwheel_label_necrolyte_laugh"	"[Laugh]"
"dota_chatwheel_label_warlock_laugh"	"[Risata]"
"[english]dota_chatwheel_label_warlock_laugh"	"[Laugh]"
"dota_chatwheel_message_beastmaster_laugh"	"Howeh heh heh eh hah heh heh heh."
"[english]dota_chatwheel_message_beastmaster_laugh"	"Howeh heh heh eh hah heh heh heh."
"dota_chatwheel_label_beastmaster_laugh"	"[Risata]"
"[english]dota_chatwheel_label_beastmaster_laugh"	"[Laugh]"
"dota_chatwheel_label_queenofpain_laugh"	"[Risata]"
"[english]dota_chatwheel_label_queenofpain_laugh"	"[Laugh]"
"dota_chatwheel_label_venomancer_laugh"	"[Risata]"
"[english]dota_chatwheel_label_venomancer_laugh"	"[Laugh]"
"dota_chatwheel_message_faceless_void_laugh"	"Heh heh hah ha hah heh heah heh."
"[english]dota_chatwheel_message_faceless_void_laugh"	"Heh heh hah ha hah heh heah heh."
"dota_chatwheel_label_faceless_void_laugh"	"[Risata]"
"[english]dota_chatwheel_label_faceless_void_laugh"	"[Laugh]"
"dota_chatwheel_message_skeleton_king_laugh"	"AH HA HA HA HA!"
"[english]dota_chatwheel_message_skeleton_king_laugh"	"AH HA HA HA HA!"
"dota_chatwheel_label_skeleton_king_laugh"	"AH HA HA HA HA!"
"[english]dota_chatwheel_label_skeleton_king_laugh"	"AH HA HA HA HA!"
"dota_chatwheel_label_death_prophet_laugh"	"[Risata]"
"[english]dota_chatwheel_label_death_prophet_laugh"	"[Laugh]"
"dota_chatwheel_label_phantom_assassin_laugh"	"[Risata]"
"[english]dota_chatwheel_label_phantom_assassin_laugh"	"[Laugh]"
"dota_chatwheel_label_pugna_laugh"	"[Risata]"
"[english]dota_chatwheel_label_pugna_laugh"	"[Laugh]"
"dota_chatwheel_label_templar_assassin_laugh"	"[Risata]"
"[english]dota_chatwheel_label_templar_assassin_laugh"	"[Laugh]"
"dota_chatwheel_message_templar_assassin_1"	"Non troveranno mai la tua tomba."
"[english]dota_chatwheel_message_templar_assassin_1"	"They'll never find your grave."
"dota_chatwheel_label_templar_assassin_1"	"Non troveranno mai la tua tomba."
"[english]dota_chatwheel_label_templar_assassin_1"	"They'll never find your grave."
"dota_chatwheel_label_viper_laugh"	"[Risata]"
"[english]dota_chatwheel_label_viper_laugh"	"[Laugh]"
"dota_chatwheel_label_luna_laugh"	"[Risata]"
"[english]dota_chatwheel_label_luna_laugh"	"[Laugh]"
"dota_chatwheel_label_dragon_knight_laugh"	"[Risata]"
"[english]dota_chatwheel_label_dragon_knight_laugh"	"[Laugh]"
"dota_chatwheel_message_dragon_knight_1"	"Hai combattuto e sei morto con onore."
"[english]dota_chatwheel_message_dragon_knight_1"	"You fought and died with honor."
"dota_chatwheel_label_dragon_knight_1"	"Hai combattuto e sei morto con onore."
"[english]dota_chatwheel_label_dragon_knight_1"	"You fought and died with honor."
"dota_chatwheel_label_dazzle_laugh"	"[Risata]"
"[english]dota_chatwheel_label_dazzle_laugh"	"[Laugh]"
"dota_chatwheel_label_rattletrap_laugh"	"[Risata]"
"[english]dota_chatwheel_label_rattletrap_laugh"	"[Laugh]"
"dota_chatwheel_label_leshrac_laugh"	"[Risata]"
"[english]dota_chatwheel_label_leshrac_laugh"	"[Laugh]"
"dota_chatwheel_message_furion_laugh"	"Ma ha ha ha ha ha ha ha ha ha!"
"[english]dota_chatwheel_message_furion_laugh"	"Ma ha ha ha ha ha ha ha ha ha!"
"dota_chatwheel_label_furion_laugh"	"[Risata]"
"[english]dota_chatwheel_label_furion_laugh"	"[Laugh]"
"dota_chatwheel_label_life_stealer_laugh"	"[Risata]"
"[english]dota_chatwheel_label_life_stealer_laugh"	"[Laugh]"
"dota_chatwheel_label_dark_seer_laugh"	"[Risata]"
"[english]dota_chatwheel_label_dark_seer_laugh"	"[Laugh]"
"dota_chatwheel_message_clinkz_laugh"	"Ah ha ha ha ha."
"[english]dota_chatwheel_message_clinkz_laugh"	"Ah ha ha ha ha."
"dota_chatwheel_label_clinkz_laugh"	"[Risata]"
"[english]dota_chatwheel_label_clinkz_laugh"	"[Laugh]"
"dota_chatwheel_label_omniknight_laugh"	"[Risata]"
"[english]dota_chatwheel_label_omniknight_laugh"	"[Laugh]"
"dota_chatwheel_message_omniknight_1"	"Un'altra macchia sul campo di battaglia."
"[english]dota_chatwheel_message_omniknight_1"	"Another stain on the battlefield."
"dota_chatwheel_label_omniknight_1"	"Un'altra macchia sul campo di battaglia."
"[english]dota_chatwheel_label_omniknight_1"	"Another stain on the battlefield."
"dota_chatwheel_label_enchantress_laugh"	"[Risata]"
"[english]dota_chatwheel_label_enchantress_laugh"	"[Laugh]"
"dota_chatwheel_label_huskar_laugh"	"[Risata]"
"[english]dota_chatwheel_label_huskar_laugh"	"[Laugh]"
"dota_chatwheel_message_huskar_thank"	"Ahh, gli dei apprezzeranno."
"[english]dota_chatwheel_message_huskar_thank"	"Ahh, this will please the gods."
"dota_chatwheel_label_huskar_thank"	"Ahh, gli dei apprezzeranno."
"[english]dota_chatwheel_label_huskar_thank"	"Ahh, this will please the gods."
"dota_chatwheel_message_bounty_hunter_thank"	"I miei alleati si sono guadagnati la loro parte."
"[english]dota_chatwheel_message_bounty_hunter_thank"	"My allies have earned their keep."
"dota_chatwheel_message_weaver_laugh"	"Hehehhehah!"
"[english]dota_chatwheel_message_weaver_laugh"	"Hehehhehah!"
"dota_chatwheel_message_jakiro_laugh"	"Ha ha ha ha ha ha ha ha ha ha ha!"
"[english]dota_chatwheel_message_jakiro_laugh"	"Ha ha ha ha ha ha ha ha ha ha ha!"
"dota_chatwheel_label_batrider_thank"	"Ora sì che si ragiona."
"[english]dota_chatwheel_label_batrider_thank"	"That's what I'm talking about."
"dota_chatwheel_message_obsidian_destroyer_5"	"Sei un folle."
"[english]dota_chatwheel_message_obsidian_destroyer_5"	"You're insane."
"dota_chatwheel_label_obsidian_destroyer_5"	"Sei un folle."
"[english]dota_chatwheel_label_obsidian_destroyer_5"	"You're insane."
"dota_chatwheel_label_ogre_magi_3"	"Devi lavorare sulle tue abilità."
"[english]dota_chatwheel_label_ogre_magi_3"	"You need to work on your skill."
"dota_chatwheel_message_rubick_4"	"Ops!"
"[english]dota_chatwheel_message_rubick_4"	"Whoops!"
"dota_chatwheel_label_rubick_4"	"Ops!"
"[english]dota_chatwheel_label_rubick_4"	"Whoops!"
"dota_chatwheel_message_naga_siren_5"	"Le mie gambe! Non mi sento le gambe."
"[english]dota_chatwheel_message_naga_siren_5"	"My legs! I can't feel my legs."
"dota_chatwheel_message_slark_laugh"	"Heh heh heh heh heh heh heh heh."
"[english]dota_chatwheel_message_slark_laugh"	"Heh heh heh heh heh heh heh heh."
"dota_chatwheel_message_troll_warlord_deny"	"Peccato."
"[english]dota_chatwheel_message_troll_warlord_deny"	"Unfortunate."
"dota_chatwheel_label_troll_warlord_deny"	"Peccato."
"[english]dota_chatwheel_label_troll_warlord_deny"	"Unfortunate."
"dota_chatwheel_message_magnataur_1"	"Ha ha ha ha! Che cosa ti aspettavi?"
"[english]dota_chatwheel_message_magnataur_1"	"Ha ha ha ha! What did you expect?"
"dota_chatwheel_message_bristleback_3"	"Oh, ne vuoi un po' anche tu... eh?"
"[english]dota_chatwheel_message_bristleback_3"	"Oh, you want some of this… eh?"
"dota_chatwheel_message_legion_commander_4"	"Figlio di...!"
"[english]dota_chatwheel_message_legion_commander_4"	"Son of a...!"
"dota_chatwheel_label_oracle_4"	"Avresti dovuto prevederlo."
"[english]dota_chatwheel_label_oracle_4"	"You should've seen that coming."
"dota_chatwheel_message_winter_wyvern_laugh"	"Ah ha ha ha ha ha ha ha ha ha ha!"
"[english]dota_chatwheel_message_winter_wyvern_laugh"	"Ah ha ha ha ha ha ha ha ha ha ha!"
"dota_chatwheel_message_monkey_king_4"	"Farò finta che non mi sia piaciuto."
"[english]dota_chatwheel_message_monkey_king_4"	"I'll pretend I didn't enjoy this."
"dota_chatwheel_label_monkey_king_4"	"Farò finta che non mi sia piaciuto."
"[english]dota_chatwheel_label_monkey_king_4"	"I'll pretend I didn't enjoy this."
"dota_chatwheel_message_dark_willow_laugh"	"Hahaha ahaha ahaha ahhahahahahaa!"
"[english]dota_chatwheel_message_dark_willow_laugh"	"Hahaha ahaha ahaha ahhahahahahaa!"
"dota_chatwheel_message_pangolier_laugh"	"Aaaah ha hahahaha hahahaaa huu."
"[english]dota_chatwheel_message_pangolier_laugh"	"Aaaah ha hahahaha hahahaaa huu."
"dota_chatwheel_message_pangolier_3"	"Bip bip!"
"[english]dota_chatwheel_message_pangolier_3"	"Beep Beep!"
"dota_chatwheel_label_pangolier_3"	"Bip bip!"
"[english]dota_chatwheel_label_pangolier_3"	"Beep Beep!"
}
